{
  "level": 1,
  "ai_total": 20,
  "ai_max_active": 4,
  "player_lives": 3,
  "player_spawn": [
    12,
    25
  ],
  "ai_spawns": [
    [
      0,
      0
    ],
    [
      8,
      0
    ],
    [
      16,
      0
    ],
    [
      24,
      0
    ]
  ],
  "spawn_interval": 90,
  "map_rows": [
    "......##..........##......",
    "..##..##..###.....##..##..",
    "..##......#C#.........##..",
    "....##....###.......##....",
    "....##..SS......SS..##....",
    "..SS....SS......SS....SS..",
    "..SS..................SS..",
    "......WWWWWWWWWWWWWW......",
    "..........................",
    "....##......##......##....",
    "....##..##..##..##..##....",
    "........##IIIIII##........",
    "..........................",
    "..........................",
    "......WWWWWWWWWWWWWW......",
    "..........................",
    "..##..................##..",
    "..##....FFFFFFFFFF....##..",
    "........FFFFFFFFFF........",
    "..........................",
    "..SS..................SS..",
    "..SS......##..##......SS..",
    "..........#....#..........",
    "..........#.C..#..........",
    "..........#....#..........",
    "..........#....#.........."
  ]
}