{
  "level": 2,
  "ai_total": 25,
  "ai_max_active": 5,
  "player_lives": 3,
  "player_spawn": [
    12,
    25
  ],
  "ai_spawns": [
    [
      0,
      0
    ],
    [
      8,
      0
    ],
    [
      16,
      0
    ],
    [
      24,
      0
    ]
  ],
  "spawn_interval": 75,
  "map_rows": [
    "..........................",
    "..........###.............",
    "..........#C#.............",
    "..........###.............",
    "##..##..##..##..##..##..##",
    "##..##..##..##..##..##..##",
    "..........................",
    "##..##..##..##..##..##..##",
    "##..##..##..##..##..##..##",
    "..........................",
    "WWWW##..##..##..##..##WWWW",
    "##..##..##..##..##..##..##",
    "....IIIIIIIIIIIIIIIIII....",
    "....IIIIIIIIIIIIIIIIII....",
    "......WWWWWWWWWWWWWW......",
    "..........................",
    "WWWW....SS......SS....WWWW",
    "........SS......SS........",
    "..FFFFFFFF......FFFFFFFF..",
    "..FFFFFFFF......FFFFFFFF..",
    "..FFFFFFFF......FFFFFFFF..",
    "..........##..##..........",
    "..........#....#..........",
    "..........#.C..#..........",
    "..........#....#..........",
    "..........#....#.........."
  ]
}