{
  "level": 3,
  "ai_total": 30,
  "ai_max_active": 6,
  "player_lives": 3,
  "player_spawn": [
    12,
    25
  ],
  "ai_spawns": [
    [
      0,
      0
    ],
    [
      8,
      0
    ],
    [
      16,
      0
    ],
    [
      24,
      0
    ]
  ],
  "spawn_interval": 60,
  "map_rows": [
    "SS......................SS",
    "SS........###...........SS",
    "..........#C#.............",
    "..........###.............",
    "..........................",
    "..##...##...##...##...##..",
    "FFFFFFFFFFFFFFFFFFFFFFFFFF",
    "FFFFFFFFFFFFFFFFFFFFFFFFFF",
    ".WWWWWWWWWWWWWWWWWWWWWWWW.",
    "......IIIIIIIIIIIIII......",
    "..........................",
    "..##...##...##...##...##..",
    "..##...##...##...##...##..",
    "..........................",
    "..........................",
    ".WWWWWWWWWWWWWWWWWWWWWWWW.",
    "......IIIIIIIIIIIIII......",
    "..##...##...##...##...##..",
    "..##...##...##...##...##..",
    "FFFFFFFFFFFFFFFFFFFFFFFFFF",
    "FFFFFFFFFFFFFFFFFFFFFFFFFF",
    "..........##..##..........",
    "..........#....#..........",
    "..........#.C..#..........",
    "..........#....#..........",
    "..........#....#.........."
  ]
}